GA 1
An Interactive Fiction by Marshall
Release 1 / Serial number 250416 / Inform 7 v10.1.2 / D

Doorway
Your neighbor Trent left his key under the doormat, practically an invitation inside. You have one mission: Freeing the neglected dog in the basement. It's constant wails have left you sleepless for weeks, and tonight is no different. There is a basement that is down from here and a kitchen to the east. Wherever you go, you know you will still hear that poor dog's wailing.

Note: Please use the command Health to check your current health.

You can see a basement door here.

>d
You try to open the door to go down and save the dog, but it is locked. What kind of sick man would bother taking the extra effort of locking the basement door in his own home each night? You figure Trent must really enjoy the power and control he feels from abusing this poor dog.

>e
Kitchen
Your neighbor Trent keeps an empty kitchen. There's a small fridge, some drawers and cupboards with chipped paint. There's a small table with a lone wooden chair.

>x fridge
The fridge has no calendar or local events on it, just a photo of a middle-aged woman.

>x photo
You flip over the photo and see the name "Sarah" scrawled on the back.

>eat photo
That's plainly inedible.

* * *

>d
You try to open the door to go down and save the dog, but it is locked. What kind of sick man would bother taking the extra effort of locking the basement door in his own home each night? You figure Trent must really enjoy the power and control he feels from abusing this poor dog.

>u
Bedroom
You enter Trent's bedroom. There he is snoring, completely unaware of your presence and the dog's howls which carry into the room. There is a bedside table with one drawer, and a small closet.

On the bed is Trent.

>open closet
You notice a small safe on the floor of the closet.

>enter 0609
You punch in the code. After a tense pause, the safe clicks open. Inside, you see a small key: the basement key.

>take all
basement key: Taken.

>d
Doorway
Your neighbor Trent left his key under the doormat, practically an invitation inside. You have one mission: Freeing the neglected dog in the basement. It's constant wails have left you sleepless for weeks, and tonight is no different. There is a basement that is down from here and a kitchen to the east. Wherever you go, you know you will still hear that poor dog's wailing.

Note: Please use the command Health to check your current health.

You can see a basement door here.

>d
You try to open the door to go down and save the dog, but it is locked. What kind of sick man would bother taking the extra effort of locking the basement door in his own home each night? You figure Trent must really enjoy the power and control he feels from abusing this poor dog.

>unlock door
(with the basement key)
You unlock the basement door.

>d
(first opening the basement door)
Finally, the dog stops wailing. It knows this is its chance, and leaps into your arms, licking your face. You can hardly remember what it's like being in the neighborhood without hearing its howls.

>i
You are carrying:
  Lily
  a basement key

>x dog
Around the dog's neck is a collar with a tag, "Lily Return to Sara 609-xxx-xxxx"

* * *

>enter 0609
You punch in the code. After a tense pause, the safe clicks open. Inside, you see a small key: the basement key.

>take key
Taken.

I beg your pardon?

>d
Doorway
Your neighbor Trent left his key under the doormat, practically an invitation inside. You have one mission: Freeing the neglected dog in the basement. It's constant wails have left you sleepless for weeks, and tonight is no different. There is a basement that is down from here and a kitchen to the east. Wherever you go, you know you will still hear that poor dog's wailing.

Note: Please use the command Health to check your current health.

You can see a basement door here.

>unlock door
(with the basement key)
You unlock the basement door.

>d
(first opening the basement door)
Finally, the dog stops wailing. It knows this is its chance, and leaps into your arms, licking your face. You can hardly remember what it's like being in the neighborhood without hearing its howls. You've got the dog. It's time to escape.

>u
Doorway
Your neighbor Trent left his key under the doormat, practically an invitation inside. You have one mission: Freeing the neglected dog in the basement. It's constant wails have left you sleepless for weeks, and tonight is no different. There is a basement that is down from here and a kitchen to the east. Wherever you go, you know you will still hear that poor dog's wailing.

Note: Please use the command Health to check your current health.

You can see a basement door here.

>undo
Basement
[Previous turn undone.]

>i
You are carrying:
  Lily
  a basement key

* * *

>take key
Taken.

>d
Doorway
Your neighbor Trent left his key under the doormat, practically an invitation inside. You have one mission: Freeing the neglected dog in the basement. It's constant wails have left you sleepless for weeks, and tonight is no different. There is a basement that is down from here and a kitchen to the east. Wherever you go, you know you will still hear that poor dog's wailing.

Note: Please use the command Health to check your current health.

You can see a basement door here.

* * *

>d
You try to open the door to go down and save the dog, but it is locked. What kind of sick man would bother taking the extra effort of locking the basement door in his own home each night? You figure Trent must really enjoy the power and control he feels from abusing this poor dog.

>open door
It seems to be locked.

>unlock door
(with the basement key)
You unlock the basement door.

>d
(first opening the basement door)

Basement
You can see a basement door here.

>i
You are carrying:
  a basement key

* * *

>d
(first opening the basement door)

Basement
You can see a basement door here.

I beg your pardon?

* * *

>u
Bedroom
You enter Trent's bedroom. There he is snoring, completely unaware of your presence and the dog's howls which carry into the room. There is a bedside table with one drawer, and a small closet.

On the bed is Trent.

>s
You can't go that way.

>n
You can't go that way.

>e
You can't go that way.

>w
You can't go that way.

>d
You can't go that way.

>u
You can't go that way.

* * *

GA 1
An Interactive Fiction by Marshall
Release 1 / Serial number 250416 / Inform 7 v10.1.2 / D

Doorway
Your neighbor Trent left his key under the doormat, practically an invitation inside. You have one mission: Freeing the neglected dog in the basement. It's constant wails have left you sleepless for weeks, and tonight is no different. There is a basement that is down from here and a kitchen to the east. Wherever you go, you know you will still hear that poor dog's wailing.

Note: Please use the command Health to check your current health.

You can see a basement door here.

>down
You try to open the door to go down and save the dog, but it is locked. You wonder what kind of sick man would bother to take the extra effort of locking the basement door in his own home each night. He must really enjoy the power and control he feels from abusing this poor dog.

* * *

GA 1
An Interactive Fiction by Marshall
Release 1 / Serial number 250416 / Inform 7 v10.1.2 / D

Doorway
Your neighbor Trent left his key under the doormat, practically an invitation inside. You have one mission: Freeing the neglected dog in the basement. It's constant wails have left you sleepless for weeks, and tonight is no different. There is a basement that is down from here and a kitchen to the east. Wherever you go, you know you will still hear that poor dog's wailing.

Note: Please use the command Health to check your current health.

You can see a basement door here.

>e
Kitchen
Your neighbor Trent keeps an empty kitchen. There's a small fridge, some drawers and cupboards with chipped paint. There's a small table with a lone wooden chair.

>eat food
You can't see any such thing.

>open fridge
You peer into a depressing world. Before you lay a six-pack of beer and some takeout food. There are no vegetables or meat to be seen. Not even so much as ketchup can be found.

>eat food
You manage to somehow eat the hamburger. It's almost flavorless, part of the burger is chewy, and part of it is crunchy. You aren't sure if it's literally poisonous or if the sensory experience being so miserable is causing you to feel queasy

>health
Your current health is 75.

>open drawer
The drawers creak as you open them, but they aren't any louder than the dog's moans. You wonder how Trent manages to sleep through all this noise, however you can still hear him snoring from upstairs. You see a single fork and knife, a clear sign of a bachelor.

* * *

>e
Kitchen
Your neighbor Trent keeps an empty kitchen. There's a small fridge, some drawers and cupboards with chipped paint. There's a small table with a lone wooden chair.

>eat photo
The photo doesn't taste like anything, but you feel a sudden wave of warmth and energy. Could it be... love? Somehow, the memories within the photo boost your vitality.

>health
Your current health is 150.

* * *

>e
Kitchen
Your neighbor Trent keeps an empty kitchen. There's a small fridge, some drawers and cupboards with chipped paint. There's a small table with a lone wooden chair.

>open cabinet
You can't see any such thing.

>open cupboard
The cupboards reveal no more than a lone plate and a bowl inside. You don't see any dog food anywhere. You wonder how Trent feeds

>take plate
Taken.

>equip plate
You equip the plate.

* * *

>e
Kitchen
Your neighbor Trent keeps an empty kitchen. There's a small fridge, some drawers and cupboards with chipped paint. There's a small table with a lone wooden chair.

>open drawer
The drawers creak as you open them, but they aren't any louder than the dog's moans. You wonder how Trent manages to sleep through all this noise, however you can still hear him snoring from upstairs. You see a single fork and knife, a clear sign of a bachelor's place. There's also a slip of paper.

>take key
Taken.

>w
Doorway
Your neighbor Trent left his key under the doormat, practically an invitation inside. You have one mission: Freeing the neglected dog in the basement. It's constant wails have left you sleepless for weeks, and tonight is no different. There is a basement that is down from here and a kitchen to the east. Wherever you go, you know you will still hear that poor dog's wailing.

Note: Please use the command Health to check your current health.

You can see a basement door here.

>down
(first opening the basement door)

Basement
Finally, the dog stops wailing. It knows this is it's chance, and leaps into your arms, licking your face. You can hardly remember what it's like being in the neighborhood without hearing its howls.

You can see a basement door here.

>use key
That's not a verb I recognise.

>unlock door
(with the basement key)
That doesn't seem to be something you can unlock.

* * *

>w
Doorway
Your neighbor Trent left his key under the doormat, practically an invitation inside. You have one mission: Freeing the neglected dog in the basement. It's constant wails have left you sleepless for weeks, and tonight is no different. There is a basement that is down from here and a kitchen to the east. Wherever you go, you know you will still hear that poor dog's wailing.

Note: Please use the command Health to check your current health.

You can see a basement door here.

>open door
You open the basement door.

>d
basement
In here is a million dollars

You can see a basement door here.

* * *

>open drawer
The drawers creak as you open them, but they aren't any louder than the dog's moans. You wonder how Trent manages to sleep through all this noise, however you can still hear him snoring from upstairs. You see a single fork and knife, a clear sign of a bachelor's place. There's also a slip of paper.

>take knife
Taken.

* * *

>e
Kitchen
Your neighbor Trent keeps an empty kitchen. There's a small fridge, some drawers and cupboards with chipped paint. There's a small table with a lone wooden chair.

>open fridge
You peer into a depressing world. Before you lay a six-pack of beer and some takeout food. There are no vegetables or meat to be seen. Not even so much as ketchup can be found.

>drink beer
You guzzle down each beer as fast as they can flow out of their can. This superhuman feat would have left you proud and elated if the dog's constant cries for help would stop for just a few minutes. You feel a newfound strength, and an increased confidence that you will free the poor dog from Trent's captivity.

* * *

>eat food
You manage to somehow eat the hamburger. It's almost flavorless, part of the burger is chewy, and part of it is crunchy. You aren't sure if it's literally poisonous or if the sensory experience being so miserable is causing you to feel queasy

>health
Your current health is 125.

* * *

>open fridge
You peer into a depressing world. Before you lay a six-pack of beer and some takeout food. There are no vegetables or meat to be seen. Not even so much as ketchup can be found.

>take beer
Taken.

>drink beer
You guzzle down each beer as fast as they can flow out of their can. This superhuman feat would have left you happy and proud, if the dog's constant cries for help could stop for just a few minutes. You feel a newfound strength, and an increased confidence that you will free the poor dog from Trent's captivity.

>health
Your current health is 125.

>w
Doorway
Your neighbor Trent left his key under the doormat, practically an invitation inside. You have one mission: Freeing the neglected dog in the basement. It's constant wails have left you sleepless for weeks, and tonight is no different. There is a basement that is down from here and a kitchen to the east. Wherever you go, you know you will still hear that poor dog's wailing.

Note: Please use the command Health to check your current health.

You can see a basement door here.

>u
Bedroom
You enter Trent's bedroom. There he is snoring, completely unaware of your presence and the dog's howls which carry into the room. There is a bedside table with one drawer, and a small closet.

On the bed is Trent.

>open closet
You notice a small safe on the floor of the closet next to a baseball bat.

>enter 0609
You punch in the code. After a tense pause, the safe clicks open. Inside, you see a small key: the basement key.

>take all
baseball bat: Taken.
basement key: Taken.

>d
Doorway
Your neighbor Trent left his key under the doormat, practically an invitation inside. You have one mission: Freeing the neglected dog in the basement. It's constant wails have left you sleepless for weeks, and tonight is no different. There is a basement that is down from here and a kitchen to the east. Wherever you go, you know you will still hear that poor dog's wailing.

Note: Please use the command Health to check your current health.

You can see a basement door here.

>unlock door with key
You unlock the basement door.

>d
(first opening the basement door)
Finally, the dog stops wailing. It knows this is its chance, and leaps into your arms, licking your face. You can hardly remember what it's like being in the neighborhood without hearing its howls. You've got the dog. It's time to escape.

>equip baseball bat
You equip the baseball bat.

>u
You open the door and to your shock, Trent is there. "I can't sleep without that damn dog barking!" he screams. In this moment, a thought appears in your head like a shockwave "Fight or Flight?". (type Fight or Flight to advance the story)

>fight
Basement
You can see a basement door here.

With Lily in your arms and the baseball bat gripped tightly, you stand your ground. Trent lunges, but you're ready. One swift swing is all it takes. He's down.

    *** You defeated Trent with the baseball bat and saved Lily! ***

Would you like to RESTART, RESTORE a saved game, QUIT or UNDO the last command?

>restart
GA 1
An Interactive Fiction by Marshall
Release 1 / Serial number 250416 / Inform 7 v10.1.2 / D

Doorway
Your neighbor Trent left his key under the doormat, practically an invitation inside. You have one mission: Freeing the neglected dog in the basement. It's constant wails have left you sleepless for weeks, and tonight is no different. There is a basement that is down from here and a kitchen to the east. Wherever you go, you know you will still hear that poor dog's wailing.

Note: Please use the command Health to check your current health.

You can see a basement door here.

>u
Bedroom
You enter Trent's bedroom. There he is snoring, completely unaware of your presence and the dog's howls which carry into the room. There is a bedside table with one drawer, and a small closet.

On the bed is Trent.

* * *

>fight
Basement
You can see a basement door here.

With Lily in your arms and the baseball bat gripped tightly, you stand your ground. Trent lunges, but you're ready. One swift swing is all it takes. He's down.

    *** You defeated Trent with the baseball bat and saved Lily! ***

Would you like to RESTART, RESTORE a saved game, QUIT or UNDO the last command?

>undo
Doorway
[Previous turn undone.]

>undo
Basement
[Previous turn undone.]

>u
You open the door and to your shock, Trent is there. "I can't sleep without that damn dog barking!" he screams. In this moment, a thought appears in your head like a shockwave "Fight or Flight?". (type Fight or Flight to advance the story)

>undo
Basement
[Previous turn undone.]

>undo
Basement
[Previous turn undone.]

* * *

>u
You open the door and to your shock, Trent is there. "I can't sleep without that damn dog barking!" he screams. In this moment, a thought appears in your head like a shockwave "Fight or Flight?". (type Fight or Flight to advance the story)

>fight
Basement
You can see a basement door here.

With Lily in your arms, there's not much you can do. A quick kick sends you tumbling down the steps.

You lost 70 health. You should equip a weapon from your inventory before fighting Trent.

>health
Your current health is 30.

>equip baseball bat
You equip the baseball bat.

* * *

>undo
Basement
[Previous turn undone.]

>health
Your current health is 30.

>u
You open the door and to your shock, Trent is there. "I can't sleep without that damn dog barking!" he screams. In this moment, a thought appears in your head like a shockwave "Fight or Flight?". (type Fight or Flight to advance the story)

>fight
Basement
You can see a basement door here.

With Lily in your arms, there's not much you can do. A quick kick sends you tumbling down the steps.

You lost 70 health. You should equip a weapon from your inventory before fighting Trent.

    *** You've been knocked out. The police are on their way, and Trent will be changing his locks. You've missed your chance to save Lily. Game over. ***

Would you like to RESTART, RESTORE a saved game, QUIT or UNDO the last command?

* * *

>e
Kitchen
Your neighbor Trent keeps an empty kitchen. There's a small fridge, some drawers and cupboards with chipped paint. There's a small table with a lone wooden chair.

>w
doorway
You can see a basement door and a basement key here.

* * *

>e
Kitchen
Your neighbor Trent keeps an empty kitchen. There's a small fridge, some drawers and cupboards with chipped paint. There's a small table with a lone wooden chair.

>x drawer
The drawers are a mix of white paint chipping off, and a light brown wood once hidden underneath. There are chips of paint on the floor. You hope the dog hasnt been eating any.

>open drawer
The drawers creak as you open them, but they aren't any louder than the dog's moans. You wonder how Trent manages to sleep through all this noise, however you can still hear him snoring from upstairs.

>take fork
Taken.

>x fork
Surprisingly clean given the state of the rest of the house.

* * *

>x fridge
The fridge has no calendar or local events on it, just a photo of a middle-aged woman.

>open fridge
It isn't something you can open.

* * *

>x fridge
The fridge has no calendar or local events on it, just a photo of a middle-aged woman.

>take photo
Taken.

>x photo
You flip over the photo and see the name "Sarah" scrawled on the back.

* * *

>x fridge
The fridge has no calendar or local events on it, just a photo of a middle-aged woman.

>x photo
You can't see any such thing.

* * *

GA 1
An Interactive Fiction by Marshall
Release 1 / Serial number 250416 / Inform 7 v10.1.2 / D

Doorway
Your neighbor Trent left his key under the doormat, practically an invitation inside. You have one mission: Freeing the neglected dog in the basement. It's constant wails have left you sleepless for weeks, and tonight is no different. There is a basement that is down from here and a kitchen to the east. Wherever you go, you know you will still hear that poor dog's wailing.

Note: Please use the command Health to check your current health.

You can see a basement door here.

>health
Your current health is 100.

* * *

GA 1
An Interactive Fiction by Marshall
Release 1 / Serial number 250416 / Inform 7 v10.1.2 / D

Doorway
Your neighbor Trent left his key under the doormat, practically an invitation inside. You have one mission: Freeing the neglected dog in the basement. It's constant wails have left you sleepless for weeks, and tonight is no different. There is a basement that is down from here and a kitchen to the east. Wherever you go, you know you will still hear that poor dog's wailing.

Note: Please use the command Health to check your current health.

You can see a basement door here.

>u
Bedroom
You enter Trent's bedroom. There he is snoring, completely unaware of your presence and the dog's howls which carry into the room. There is a bedside table with one drawer, and a small closet.

On the bed is Trent.

>enter 6090
You enter 6090 into the keypad. A red light blinks. Wrong code.

>open drawer
You can't see any such thing.

>open bedside table
You open the bedside table, revealing a calendar.

>x calendar
It is opened to June and the 9th day is X'ed out with countless X's.

>tale calendar
That's not a verb I recognise.

>take calendar
Taken.

>enter 0609
You punch in the code. After a tense pause, the safe clicks open. Inside, you see a small key: the basement key.

>take key
You can't see any such thing.

>take basement key
You can't see any such thing.

>x key
You can't see any such thing.

>x safe
You can't see any such thing.

>open closet
You open the closet, revealing nothing.

>x safe
A small metal safe with a keypad. It looks like it could be opened with the right 4-digit code.

In the safe is a basement key.

>enter 0609
The safe is already open.

>take key
Taken.

* * *

>u
Bedroom
You enter Trent's bedroom. There he is snoring, completely unaware of your presence and the dog's howls which carry into the room. There is a bedside table with one drawer, and a small closet.

On the bed is Trent.

>enter 9060
You enter 9060 into the keypad. A red light blinks. Wrong code.

* * *

>u
Bedroom
You enter Trent's bedroom. There he is snoring, completely unaware of your presence and the dog's howls which carry into the room. There is a bedside table with one drawer, and a small closet.

On the bed is Trent.

>kiss Trent
*** As you lock lips, Trent's eyes bolt open. He is a massive man, and wrestles you to the ground. You don't remember what happens next, but you wake up in a nearby ditch, unable to move. ***

Would you like to RESTART, RESTORE a saved game, QUIT or UNDO the last command?

>undo
Bedroom
[Previous turn undone.]

>touch trent
*** As you slide your hand across Trent's chest, Trent's eyes bolt open. He is a massive man, and wrestles you to the ground. You don't remember what happens next, but you wake up in a nearby ditch, unable to move. ***

Would you like to RESTART, RESTORE a saved game, QUIT or UNDO the last command?

* * *

>enter 0609
You punch in the code. After a tense pause, the safe clicks open. Inside, you see a small key: the basement key.

>d
Doorway
Your neighbor Trent left his key under the doormat, practically an invitation inside. You have one mission: Freeing the neglected dog in the basement. It's constant wails have left you sleepless for weeks, and tonight is no different. There is a basement that is down from here and a kitchen to the east. Wherever you go, you know you will still hear that poor dog's wailing.

Note: Please use the command Health to check your current health.

You can see a basement door here.

>d
(first opening the basement door)
As you reach the bottom of the basement stairs, a small frail dog jumps into your arms. It knows this is it's chance to escape.

>x dog
Around the dog's neck is a collar with a tag, "Lily Return to Sara 609-xxx-xxxx"

* * *

>d
(first opening the basement door)
As you reach the bottom of the basement stairs, a small frail dog jumps into your arms. It knows this is it's chance to escape.

>x lily
Around the dog's neck is a collar with a tag, " Lily /n Return to Sara 609-xxx-xxxx"

* * *

>d
Doorway
Your neighbor Trent left his key under the doormat, practically an invitation inside. You have one mission: Freeing the neglected dog in the basement. It's constant wails have left you sleepless for weeks, and tonight is no different. There is a basement that is down from here and a kitchen to the east. Wherever you go, you know you will still hear that poor dog's wailing.

Note: Please use the command Health to check your current health.

You can see a basement door here.

>e
Kitchen
Your neighbor Trent keeps an empty kitchen. There's a small fridge, some drawers and cupboards with chipped paint. There's a small table with a lone wooden chair.

* * *

>open drawer
The drawers creak as you open them, but they aren't any louder than the dog's moans. You wonder how Trent manages to sleep through all this noise, however you can still hear him snoring from upstairs. You see a single fork and knife, a clear sign of a bachelor's place. There's also a slip of paper.

>take all
fork: Taken.
knife: Taken.
paper: Taken.

>w
Doorway
Your neighbor Trent left his key under the doormat, practically an invitation inside. You have one mission: Freeing the neglected dog in the basement. It's constant wails have left you sleepless for weeks, and tonight is no different. There is a basement that is down from here and a kitchen to the east. Wherever you go, you know you will still hear that poor dog's wailing.

Note: Please use the command Health to check your current health.

You can see a basement door here.

>unlock door with key
You unlock the basement door.

* * *

>d
(first opening the basement door)
Finally, the dog stops wailing. It knows this is its chance, and leaps into your arms, licking your face. You can hardly remember what it's like being in the neighborhood without hearing its howls. You've got the dog. It's time to escape.

>equip paper
You equip the paper.

>u
You open the door and to your shock, Trent is there. "I can't sleep without that damn dog barking!" he screams. In this moment, a thought appears in your head like a shockwave "Fight or Flight?". (type Fight or Flight to advance the story)

>fight
Basement
You can see a basement door here.

You take a heavy blow, but your weapon gives you just enough of an edge to push back. You win the fight.

    *** You defeated Trent and saved Lily! ***

Would you like to RESTART, RESTORE a saved game, QUIT or UNDO the last command?

* * *

>d
Doorway
Your neighbor Trent left his key under the doormat, practically an invitation inside. You have one mission: Freeing the neglected dog in the basement. It's constant wails have left you sleepless for weeks, and tonight is no different. There is a basement that is down from here and a kitchen to the east. Wherever you go, you know you will still hear that poor dog's wailing.

Note: Please use the command Health to check your current health.

You can see a basement door here.

>unlock door with kety
You can't see any such thing.

>unlock door with key
You unlock the basement door.

* * *

>d
(first opening the basement door)
Finally, the dog stops wailing. It knows this is its chance, and leaps into your arms, licking your face. You can hardly remember what it's like being in the neighborhood without hearing its howls. You've got the dog. It's time to escape.

>u
You open the door and to your shock, Trent is there. "I can't sleep without that damn dog barking!" he screams. In this moment, a thought appears in your head like a shockwave "Fight or Flight?". (type Fight or Flight to advance the story)

* * *

>fight
Basement
You can see a basement door here.

With Lily in your arms, there's not much you can do. A quick kick sends you tumbling down the steps.

You lost 70 health. You should equip a weapon from your inventory before fighting Trent.

>equip bat
You equip the baseball bat.

>u
You open the door and to your shock, Trent is there. "I can't sleep without that damn dog barking!" he screams. In this moment, a thought appears in your head like a shockwave "Fight or Flight?". (type Fight or Flight to advance the story)

>fight
Basement
You can see a basement door here.

With Lily in your arms and the baseball bat gripped tightly, you stand your ground. Trent lunges, but you're ready. One swift swing is all it takes. He's down.

You lost 30 health, but the bat gave you the upper hand.

    *** You've been knocked out. The police are on their way, and Trent will be changing his locks. You've missed your chance to save Lily. Game over. ***

Would you like to RESTART, RESTORE a saved game, QUIT or UNDO the last command?

* * *

>fight
Basement
You can see a basement door here.

With Lily in your arms, there's not much you can do. A quick kick sends you tumbling down the steps.

You lost 70 health. You should equip a weapon from your inventory before fighting Trent.

>equip baseball bat
You equip the baseball bat.

* * *

>u
You open the door and to your shock, Trent is there. "I can't sleep without that damn dog barking!" he screams. In this moment, a thought appears in your head like a shockwave "Fight or Flight?". (type Fight or Flight to advance the story)

>fight
Basement
You can see a basement door here.

You lost 30 health, but the bat gave you the upper hand.

    *** You've been knocked out. The police are on their way, and Trent will be changing his locks. You've missed your chance to save Lily. Game over. ***

Would you like to RESTART, RESTORE a saved game, QUIT or UNDO the last command?

* * *

>d
Doorway
Your neighbor Trent left his key under the doormat, practically an invitation inside. You have one mission: Freeing the neglected dog in the basement. It's constant wails have left you sleepless for weeks, and tonight is no different. There is a basement that is down from here and a kitchen to the east. Wherever you go, you know you will still hear that poor dog's wailing.

Note: Please use the command Health to check your current health.

You can see a basement door here.

>d
(first opening the basement door)

    *** You step into the basement, free the dog, and win! ***

Would you like to RESTART, RESTORE a saved game, QUIT or UNDO the last command?

* * *

>d
Doorway
Your neighbor Trent left his key under the doormat, practically an invitation inside. You have one mission: Freeing the neglected dog in the basement. It's constant wails have left you sleepless for weeks, and tonight is no different. There is a basement that is down from here and a kitchen to the east. Wherever you go, you know you will still hear that poor dog's wailing.

Note: Please use the command Health to check your current health.

You can see a basement door here.

>open door
It seems to be locked.

>d
You try to open the door to go down and save the dog, but it is locked. What kind of sick man would bother taking the extra effort of locking the basement door in his own home each night? You figure Trent must really enjoy the power and control he feels from abusing this poor dog.

* * *

>u
Bedroom
You enter Trent's bedroom. There he is snoring, completely unaware of your presence and the dog's howls which carry into the room. There is a bedside table with one drawer, and a small closet.

On the bed is Trent.

>d
Doorway
Your neighbor Trent left his key under the doormat, practically an invitation inside. You have one mission: Freeing the neglected dog in the basement. It's constant wails have left you sleepless for weeks, and tonight is no different. There is a basement that is down from here and a kitchen to the east. Wherever you go, you know you will still hear that poor dog's wailing.

Note: Please use the command Health to check your current health.

You can see a basement door here.

* * *

>u
You open the door and to your shock, Trent is there. "I can't sleep without that damn dog barking!" he screams. In this moment, a thought appears in your head like a shockwave "Fight or Flight?". (type Fight or Flight to advance the story)

>health
Your current health is 100.

* * *

>d
(first opening the basement door)
Finally, the dog stops wailing. It knows this is its chance, and leaps into your arms, licking your face. You can hardly remember what it's like being in the neighborhood without hearing its howls. You've got the dog. It's time to escape.

>equip key
You equip the basement key.

>u
You open the door and to your shock, Trent is there. "I can't sleep without that damn dog barking!" he screams. In this moment, a thought appears in your head like a shockwave "Fight or Flight?". (type Fight or Flight to advance the story)

>fight
Basement
You can see a basement door here.

With Lily in your arms, and the weapon equipped, you face Trent with determination. You take a heavy blow but your weapon helps you fight back. You win this fight!

    *** You defeated Trent and saved Lily. Congratulations! ***

Would you like to RESTART, RESTORE a saved game, QUIT or UNDO the last command?

>restart
GA 1
An Interactive Fiction by Marshall
Release 1 / Serial number 250416 / Inform 7 v10.1.2 / D

Doorway
Your neighbor Trent left his key under the doormat, practically an invitation inside. You have one mission: Freeing the neglected dog in the basement. It's constant wails have left you sleepless for weeks, and tonight is no different. There is a basement that is down from here and a kitchen to the east. Wherever you go, you know you will still hear that poor dog's wailing.

Note: Please use the command Health to check your current health.

You can see a basement door here.

>e
Kitchen
Your neighbor Trent keeps an empty kitchen. There's a small fridge, some drawers and cupboards with chipped paint. There's a small table with a lone wooden chair.

>open cupboard
The cupboards reveal no more than a lone plate and a bowl inside. You don't see any dog food anywhere. You wonder how Trent feeds

>take all
plate: Taken.
bowl: Taken.

>w
Doorway
Your neighbor Trent left his key under the doormat, practically an invitation inside. You have one mission: Freeing the neglected dog in the basement. It's constant wails have left you sleepless for weeks, and tonight is no different. There is a basement that is down from here and a kitchen to the east. Wherever you go, you know you will still hear that poor dog's wailing.

Note: Please use the command Health to check your current health.

You can see a basement door here.

* * *

>u
Bedroom
You enter Trent's bedroom. There he is snoring, completely unaware of your presence and the dog's howls which carry into the room. There is a bedside table with one drawer, and a small closet.

On the bed is Trent.

>enter closet
That's not something you can enter.

>open closet
You notice a small safe on the floor of the closet next to a baseball bat.

* * *

>d
Doorway
Your neighbor Trent left his key under the doormat, practically an invitation inside. You have one mission: Freeing the neglected dog in the basement. It's constant wails have left you sleepless for weeks, and tonight is no different. There is a basement that is down from here and a kitchen to the east. Wherever you go, you know you will still hear that poor dog's wailing.

Note: Please use the command Health to check your current health.

You can see a basement door here.

>unlock door
What do you want to unlock the basement door with?

>unlock door with key
You unlock the basement door.

* * *

>d
(first opening the basement door)
Finally, the dog stops wailing. It knows this is its chance, and leaps into your arms, licking your face. You can hardly remember what it's like being in the neighborhood without hearing its howls. You've got the dog. It's time to escape.

>i
You are carrying:
  Lily
  a basement key

>u
You open the door and to your shock, Trent is there. "I can't sleep without that damn dog barking!" he screams. In this moment, a thought appears in your head like a shockwave "Fight or Flight?". (type Fight or Flight to advance the story)

>flight
Basement
You can see a basement door here.

You turn and fly down the stairs with Lily in your arms, narrowly dodging a kick from Trent, who tried to send you tumbling down the stairs. You can't beat Trent and save Lily with her in your arms. You should drop Lily and EQUIP a weapon to fight Trent with.

>equip basement key
You equip the basement key.

>u
You open the door and to your shock, Trent is there. "I can't sleep without that damn dog barking!" he screams. In this moment, a thought appears in your head like a shockwave "Fight or Flight?". (type Fight or Flight to advance the story)

>Fight
Basement
You can see a basement door here.

You swing wildly, but your opponent is quicker. A sharp blow lands and you reel, stumbling through a door and down the steps...

You lost 70 health.

>u
You open the door and to your shock, Trent is there. "I can't sleep without that damn dog barking!" he screams. In this moment, a thought appears in your head like a shockwave "Fight or Flight?". (type Fight or Flight to advance the story)

>d
Finally, the dog stops wailing. It knows this is its chance, and leaps into your arms, licking your face. You can hardly remember what it's like being in the neighborhood without hearing its howls. You've got the dog. It's time to escape.

>drop lily
Dropped.

* * *

>u
Bedroom
You enter Trent's bedroom. There he is snoring, completely unaware of your presence and the dog's howls which carry into the room. There is a bedside table with one drawer, and a small closet.

On the bed is Trent.

* * *

>u
You open the door and to your shock, Trent is there. "I can't sleep without that damn dog barking!" he screams. In this moment, a thought appears in your head like a shockwave "Fight or Flight?". (type Fight or Flight to advance the story)

>fight
Basement
You can see a basement door here.

You swing wildly, but your opponent is quicker. A sharp blow lands and you reel, stumbling through a door and down the steps...

You lost 70 health.

* * *

>flight
Basement
You can see a basement door here.

You turn and fly down the stairs with Lily in your arms, narrowly dodging a kick from Trent, who tried to send you tumbling down the stairs. You can't beat Trent and save Lily with her in your arms. You should drop Lily and EQUIP a weapon to fight Trent with.

>equip key
You equip the basement key.

* * *

>u
You open the door and to your shock, Trent is there. "I can't sleep without that damn dog barking!" he screams. In this moment, a thought appears in your head like a shockwave "Fight or Flight?". (type Fight or Flight to advance the story)

>u
Bedroom
You enter Trent's bedroom. There he is snoring, completely unaware of your presence and the dog's howls which carry into the room. There is a bedside table with one drawer, and a small closet.

On the bed is Trent.

* * *

>i
You are carrying:
  a basement key

* * *

>open closet
You notice a small safe on the floor of the closet next to a baseball bat.

>take baseball bat
Taken.

>enter 0609
You punch in the code. After a tense pause, the safe clicks open. Inside, you see a small key: the basement key.

* * *

>unlock door
What do you want to unlock the basement door with?

>key
You unlock the basement door.

>d
(first opening the basement door)

>d
You can't go that way.

* * *

I beg your pardon?

I beg your pardon?

>i
You are carrying:
  a basement key
  a baseball bat

>u
Bedroom
You enter Trent's bedroom. There he is snoring, completely unaware of your presence and the dog's howls which carry into the room. There is a bedside table with one drawer, and a small closet.

On the bed is Trent.

* * *

>unlock door
What do you want to unlock the basement door with?

>unlock door with key
That's unlocked at the moment.

>d
You can't go that way.

* * *

>open closet
You notice a small safe on the floor of the closet next to a baseball bat.

>x safe
A small metal safe with a keypad. It looks like it could be opened with the right 4-digit code.

>enter 0609
You punch in the code. After a tense pause, the safe clicks open. Inside, you see a small key: the basement key.

>take basement key
Taken.

>d
Doorway
Your neighbor Trent left his key under the doormat, practically an invitation inside. You have one mission: Freeing the neglected dog in the basement. It's constant wails have left you sleepless for weeks, and tonight is no different. There is a basement that is down from here and a kitchen to the east. Wherever you go, you know you will still hear that poor dog's wailing.

Note: Please use the command Health to check your current health.

You can see a basement door here.

>open basement door
You open the basement door.

>d
Basement
Finally, the dog stops wailing. It knows this is it's chance, and leaps into your arms, licking your face. You can hardly remember what it's like being in the neighborhood without hearing its howls.

You can see a basement door here.

>x dog
You can't see any such thing.

* * *

>u
Bedroom
You enter Trent's bedroom. There he is snoring, completely unaware of your presence and the dog's howls which carry into the room. There is a bedside table with one drawer, and a small closet.

On the bed is Trent.

>take baseball bat
You can't see any such thing.

>open closet
You notice a small safe on the floor of the closet next to a baseball bat.

* * *

>take baseball bat
Taken.

>d
Doorway
Your neighbor Trent left his key under the doormat, practically an invitation inside. You have one mission: Freeing the neglected dog in the basement. It's constant wails have left you sleepless for weeks, and tonight is no different. There is a basement that is down from here and a kitchen to the east. Wherever you go, you know you will still hear that poor dog's wailing.

Note: Please use the command Health to check your current health.

You can see a basement door here.

>unlock door
(with the baseball bat)
That doesn't seem to fit the lock.

* * *

>u
Bedroom
You enter Trent's bedroom. There he is snoring, completely unaware of your presence and the dog's howls which carry into the room. There is a bedside table with one drawer, and a small closet.

On the bed is Trent.

>x safe
You can't see any such thing.

* * *

GA 1
An Interactive Fiction by Marshall
Release 1 / Serial number 250416 / Inform 7 v10.1.2 / D

Doorway
Your neighbor Trent left his key under the doormat, practically an invitation inside. You have one mission: Freeing the neglected dog in the basement. It's constant wails have left you sleepless for weeks, and tonight is no different. There is a basement that is down from here and a kitchen to the east. Wherever you go, you know you will still hear that poor dog's wailing.

Note: Please use the command Health to check your current health.

You can see a basement door here.

>up
Bedroom
You enter Trent's bedroom. There he is snoring, completely unaware of your presence and the dog's howls which carry into the room. There is a bedside table with one drawer, and a small closet.

On the bed is Trent.

>open closet
You notice a small safe on the floor of the closet.

* * *

>take key
Taken.

>down
Doorway
Your neighbor Trent left his key under the doormat, practically an invitation inside. You have one mission: Freeing the neglected dog in the basement. It's constant wails have left you sleepless for weeks, and tonight is no different. There is a basement that is down from here and a kitchen to the east. Wherever you go, you know you will still hear that poor dog's wailing.

Note: Please use the command Health to check your current health.

You can see a basement door here.

>d
(first opening the basement door)
As you reach the bottom of the basement stairs, a small frail dog jumps into your arms. It knows this is it's chance to escape.

>x lily
Around the dog's neck is a collar with a tag, " Lily Return to Sara 609-xxx-xxxx"

* * *

>open closet
You notice a small safe on the floor of the closet.

>enter 6090
You enter 6090 into the keypad. A red light blinks. Wrong code.

>enter 0609
You punch in the code. After a tense pause, the safe clicks open. Inside, you see a small key: the basement key.

* * *

>down
Doorway
Your neighbor Trent left his key under the doormat, practically an invitation inside. You have one mission: Freeing the neglected dog in the basement. It's constant wails have left you sleepless for weeks, and tonight is no different. There is a basement that is down from here and a kitchen to the east. Wherever you go, you know you will still hear that poor dog's wailing.

Note: Please use the command Health to check your current health.

You can see a basement door here.

>down
(first opening the basement door)
As you reach the bottom of the basement stairs, a small frail dog jumps into your arms. It knows this is it's chance to escape.

>x dog
You can't see any such thing.

>x lily
Around the dog's neck is a collar with a tag, "Lily return to Sara 609-xxx-xxxx"

* * *

>open closet
You notice a small safe on the floor of the closet.

>open safe
It seems to be locked.

>0609
That's not a verb I recognise.

>enter 0609
You punch in the code. After a tense pause, the safe clicks open. Inside, you see a small key: the basement key.

>enter bed
You get onto the bed.

On the bed you can see Trent.

>kiss trent
Trent might not like that.

* * *

GA 1
An Interactive Fiction by Marshall
Release 1 / Serial number 250416 / Inform 7 v10.1.2 / D

Doorway
Your neighbor Trent left his key under the doormat, practically an invitation inside. You have one mission: Freeing the neglected dog in the basement. It's constant wails have left you sleepless for weeks, and tonight is no different. There is a basement that is down from here and a kitchen to the east. Wherever you go, you know you will still hear that poor dog's wailing.

Note: Please use the command Health to check your current health.

You can see a basement door here.

>w
You can't go that way.

>e
Kitchen
Your neighbor Trent keeps an empty kitchen. There's nothing on his fridge, and the paint has chipped on his drawer and cupboard. There's a small table with a lone wooden chair.

You can see a fridge (closed), a drawer (closed) and a cupboard (closed) here.

>open fridge
You open the fridge, revealing a beer and an old takeout food.

>take beer
Taken.

>drink beer
There's nothing suitable to drink here.

* * *

GA 1
An Interactive Fiction by Marshall
Release 1 / Serial number 250416 / Inform 7 v10.1.2 / D

Doorway
Your neighbor Trent left his key under the doormat, practically an invitation inside. You have one mission: Freeing the neglected dog in the basement. It's constant wails have left you sleepless for weeks, and tonight is no different. There is a basement that is down from here and a kitchen to the east. Wherever you go, you know you will still hear that poor dog's wailing.

Note: Please use the command Health to check your current health.

You can see a basement door here.

>x all
You can't use multiple objects with that verb.

>x
What do you want to examine?

>x key
You see nothing special about the basement key.

>take key
Taken.

>d
(first opening the basement door)

basement
You can see a basement door here.

>u
doorway
You can see a basement door here.

* * *

GA 1
An Interactive Fiction by Marshall
Release 1 / Serial number 250416 / Inform 7 v10.1.2 / D

Doorway
Your neighbor Trent left his key under the doormat, practically an invitation inside. You have one mission: Freeing the neglected dog in the basement. It's constant wails have left you sleepless for weeks, and tonight is no different. There is a basement that is down from here and a kitchen to the east. Wherever you go, you know you will still hear that poor dog's wailing.

Note: Please use the command Health to check your current health.

You can see a basement door here.

>y
That was a rhetorical question.

>u
Bedroom
You enter Trent's bedroom. There he is snoring, completely unaware of your presence and the dog's howls which carry into the room. There is a bedside table with one drawer, and a small closet.

On the bed is Trent.